A format is NEVER part of a data recovery or disk rebuild process and if done in such circumstances will normally lead to loss of all data on the disks being formatted=Formatteren is **NOOIT** onderdeel van gegevensherstel of diskopbouw en leidt tot gegevensverlies wanneer onbedoeld schijven worden geformatteerd
Aborted=Afgebroken
Add=Toevoegen
Add Pool=Groep toevoegen
All existing data on this device will be OVERWRITTEN when array is Started=Alle bestaande gegevens op deze opslag worden OVERSCHREVEN wanneer de array is gestart
Array Devices=Array opslag
Array of %s devices=Array opslag bestaat uit %s schijven
Array Operation=Array besturing
Attribute Name=Attribuutnaam
Attributes=Attributen
Balance Status=Balans Status
Balance=Balans
Blacklisted=Op zwarte lijst
Boot Device=Opstartmedium
Boot system in UEFI mode=Systeem opstarten in UEFI-modus
btrfs balance status=btrfs balans status
btrfs check status=btrfs controle status
btrfs filesystem df=btrfs bestandsysteem df
BTRFS operation is running=BTRFS bewerking is bezig
btrfs scrub status=btrfs boen status
Can not read attributes=Kan de attributen niet lezen
Can not read capabilities=Kan de mogelijkheden niet lezen
Can not read identification=Kan de identificatie niet lezen
Canceled=Afgebroken
Cannot contact key-server Please check your=Kan geen verbinding maken met de sleutelserver. Controleer uw
Capabilities=Mogelijkheden
Check Filesystem Status=Controleer bestandsysteem status
Clear Stats=Opschonen
Clearing in progress=Leegmaken is bezig
Click to spin down device=Druk om opslag uit te zetten
Click to spin up device=Druk om opslag aan te zetten
Comments=Opmerkingen
complete=voltooid
Completed without error=Voltooid zonder fouten
Configuration valid=Configuratie is geldig
Convert to raid0 mode=Converteer naar raid0-modus
Convert to raid1 mode=Converteer naar raid1-modus
Convert to raid10 mode=Converteer naar raid10-modus
Convert to raid5 mode see help=Converteer naar raid5-modus *zie hulp
Convert to raid6 mode see help=Converteer naar raid6-modus *zie hulp
Convert to single mode=Converteer naar single-modus
Copying=Kopiërende
corrected=gecorrigeerd
Create an empty file system on the disks shown as Unmountable discarding all data currently on the disks and update parity to reflect this=Maak een leeg bestandssysteem aan op de schijven die ontkoppeld zijn, gooi alle huidige gegevens weg en werk de pariteit bij om dit weer te geven
Creating Flash backup=Flash reservekopie maken
creating Flash backup zip file this may take several minutes=bezig met maken van een Flash reservekopie zip-bestand (dit kan enkele minuten duren)
Creation error=Aanmaakfout
Critical disk temperature threshold=Schijftemperatuur alertniveau
Critical disk utilization threshold=Schijfgebruik alertniveau
Current operation %s on %s=Huidige bewerking %s op **%s**
Current position=Huidige positie
Custom attributes use comma to separate numbers=Aangepaste attributen (gebruik komma om getallen te scheiden)
Date of purchase=Aankoopdatum
Date=Datum
Delete Pool=Groep verwijderen
detected=gedetecteerd
Device encrypted and unlocked=Opslag is versleuteld en ontgrendeld
Device encrypted=Opslag is versleuteld
Device is part of a pool=Opslag is onderdeel van een groep
Device locked unknown error=Opslag is vergrendeld: onbekende fout
Device locked wrong encryption key=Opslag is vergrendeld: verkeerde versleuteling
Device to be encrypted=Opslag wordt versleuteld
Disk in parity slot is not biggest=Schijf in pariteit slot is niet de grootste
Disk Log Information=Schijflogboekinformatie
Do not use reserved names=Gebruik geen gereserveerde namen
Do not use user share names=Gebruik geen namen van gebruikersmappen
Download SMART report=Download SMART rapportage
Dual parity valid requires ALL disks in their original slots=*Geldige dubbele pariteit* vereist dat **ALLE** schijven in hun oorspronkelijke positie zijn geplaatst
Elapsed time=Verstreken tijd
Enable user share assignment=Toewijzing voor gebruikersmappen
Erase=Wissen
Erase Device Content=Wis inhoud van de opslag
encrypted=versleuteld
Encryption input=Versleutelingsinvoer
Encryption status=Versleutelingsstatus
Enter new key=Voer een nieuwe sleutel in
Errors occurred - Check SMART report=Fouten opgetreden - Zie SMART rapportage
Estimated finish=Geschatte einde
Estimated speed=Geschatte snelheid
Existing content is permanently lost=Bestaande inhoud is permanent verloren
Failed=Mislukt
Feature=Kenmerk
File system status=Bestandsysteem status
File system type=Bestandsysteem type
Finding %s error=Gevonden fouten: **%s**
Finding %s errors=Gevonden fouten: **%s**
Flag=Vlag
Flash backup=Flash reservekopie
Flash Device Settings=Flash opslaginstellingen
Format Unmountable disks=Ontkoppelde schijven formatteren
Formatting=Formatteren
formatting=formatteren
Free=Beschikbaar
FS=FS
Global Configuration=Globale Configuratie
Hide=Verbergen
Identification=Identificatie
Identity=Identiteit
if checked, Start array but do not mount disks=indien aangevinkt, start de array maar koppel geen schijven
If this is a new array, move the largest disk into the parity slot=Indien dit een nieuwe array is, verplaats de grootste schijf naar het *pariteit* slot
If you are adding a new disk or replacing a disabled disk, try Parity-Swap=Indien u een nieuwe schijf toevoegt of een uitgeschakelde schijf vervangt, probeer dan Parity-Swap
If you want to preserve the data on the new disks, reset the array configuration and rebuild parity instead=Indien u de gegevens van de nieuwe schijven wilt behouden, herzet dan de configuratie van de array en bouw de pariteit opnieuw op
Information=Informatie
Install a replacement disk as soon as possible=Installeer zo spoedig mogelijk een vervangende schijf
Insufficient free disk space available=Onvoldoende beschikbare schijfruimte 
Interrupted=Onderbroken
Invalid configuration=Ongeldige configuratie
Invalid expansion=Ongeldige uitbreiding
Invalid pool name=Ongeldige groepnaam
is only available when array is Started in Maintenance mode=is alleen beschikbaar wanneer de array is gestart in **Onderhoudsmodus**
is only available when array is Started=is alleen beschikbaar wanneer de array is gestart
Keyfile=Sleutelbestand
Last check completed on %s=Laatste controle is voltooid op **%s**
Last check incomplete on %s=Laatste controle is onvoltooid op **%s**
Last checked on %s=Laatste controle op **%s**
Last SMART test result=Laatste SMART testresultaat
Maintenance mode=Onderhoudsmodus
Maintenance Mode=Onderhoudsmodus
Maintenance=Onderhoud
Manufacturing date=Fabricage datum
Menu View=Menuweergave
Minimum free space=Minimale vrije ruimte
Missing Cache disk=Ontbrekende groep schijf
Missing disk=Ontbrekende schijf
Missing key=Ontbrekende sleutel
Missing=Ontbrekend
Mounted=Gekoppeld
Mover is running=Mover is bezig
network settings=netwerkinstellingen
New data disks detected=Nieuwe dataschijven gedetecteerd
No array data disks have been assigned=Er zijn geen dataschijven toegekend aan de array
No data disks=Geen dataschijven
No parity check history present=Geen pariteitscontrole overzicht aanwezig
No self-tests logged on this disk=Geen zelftest gelogd voor deze schijf
Not installed=Niet geïnstalleerd
Note do not use pool names which are also used as user share names=Letop: gebruik geen groepnamen die ook voor gebruikersmappen worden gebruikt
OK=Ok
Once clear completes, the array may be Started, expanding the array to include the new disks=Wanneer *leegmaken* is voltooid kan de array actief worden gemaakt, en wordt deze uitgebreid met de nieuwe schijven
Once copy completes, the array may be Started, to initiate Data-Rebuild of the disabled disk=Wanneer kopiëren is voltooid kan de array actief worden gemaakt, dit initieert een gegevensherbouw van de uitgeschakelde schijf
operation=bewerking
Options see Help=Opties (zie Hulp)
Otherwise use the keyfile method for UTF8 input=Gebruik anders de **sleutelbestand** methode voor UTF8-invoer
Parity disks content will be overwritten=De inhoud van de *Pariteitschijven* zal worden overschreven
Parity is already valid=Pariteit is al geldig
Parity operation is running=Pariteitsbewerking is bezig
Parity valid requires ALL disks to have their original content=*Geldige pariteit* vereist dat **ALLE** schijven hun oorspronkelijke inhoud hebben
Parity-Check in progress=Pariteitscontrole is bezig
ParityRead-Check History=Pariteits-/Leescontrole overzicht
Parity-SyncData-Rebuild in progress=Pariteitssynchronisatie/gegevensherbouw is bezig
Partition format=Partitie formaat
Partition size=Partitie grootte
Passed=Geslaagd
Passphrase=Wachtwoordzin
Perform full balance=Voer een volledige balans uit
Permit UEFI boot mode=UEFI-opstartmodus toestaan
Please check your system settings to support UEFI boot mode=Controleer de instellingen van uw systeem voor UEFI-ondersteuning
Pool Devices=Groep opslag
Pool name already exists=Groepnaam bestaat al
Pool of %s devices=Groep opslag bestaat uit %s schijven
Preclear in progress=Preclear is bezig
Printable Characters Only=Alleen leesbare karakters
Proceed to start=Doorgaan met starten
Raw Value=Ruwe waarde
Raw View=Ruwe weergave
Read-Check in progress=Leescontrole is bezig
Reboot in safe mode=Herstarten in veilige modus
registration key=Registratie code
Registration Key Manager=Registratie Pagina
reiserfsck status=reiserfsck status
Rename Pool=Groep hernoemen
Rename=Hernoemen
Repair corrupted blocks=Repareer corrupte blokken
Replacement disk installed=Vervangende schijf is geïnstalleerd
Replacement disk is too small=Vervangende schijf is te klein
Retype passphrase=Wachtwoordzin herinvoeren
Schedule=Planner
Scrub Status=Boen Status
Scrub=Boenen
See Cache Settings=Zie groepinstellingen
self-test in progress=zelftest is bezig
Self-Test=Zelftest
Server boot mode=Server opstartmodus
Set default boot menu=Standaard opstartmenu instellen
show passphrase=wachtwoordzin tonen
Show=Tonen
Slots=Sloten
SMART attribute notifications=SMART attributen meldingen
SMART error log=SMART foutenlogboek
SMART extended self-test=SMART uitgebreide zelftest
SMART health-check failed=SMART gezondheidscontrole mislukt
SMART notification value=SMART meldingen waarde
SMART self-test history=SMART zelftest overzicht
SMART Settings=SMART Instellingen
SMART short self-test=SMART korte zelftest
SMART status=SMART status
Speed=Snelheid
Spin down delay=Uitzet tijd
Spin Down=Uitzetten
Spin Up=Aanzetten
Spinup groups=Groepen aanzetten
Started, array protected=Gestart, de array is beschermd
Started, array unprotected=Gestart, de array is onbeschermd
Started, formatting=Gestart, formatteren
Starting=Startende
Stopping=Stoppende
Sync errors=Sync fouten
Sync=Sync
Syslinux Configuration=Syslinux Configuratie
Syslinux configuration=Syslinux configuratie
Temp=Temp
The array will be immediately available, but unprotected since parity has not been assigned=De array is onmiddellijk beschikbaar, maar **onbeschermd** omdat *pariteit* nog niet is toegewezen
The array will be immediately available, but unprotected until Parity-Sync completes=De array is onmiddellijk beschikbaar, maar **onbeschermd** totdat pariteitssynchronisatie is voltooid
The replacement disk must be as big or bigger than the original=De vervangende schijf moet even groot of groter zijn dan de originele schijf
This is typically done when a new disk is added to the array to get it ready for files to be written to it=Dit wordt meestal gedaan wanneer een nieuwe schijf wordt toegevoegd aan de array en gereed is om beschreven te worden
This unRAID Server OS release has been withdrawn and may no longer be used. Please %s update your server=Deze uitgave van Unraid is ingetrokken en kan niet langer worden gebruikt. A.u.b. %s upgrade uw systeem
This will ERASE ALL device content=Dit WIST ALLE inhoud van de opslag
This will ERASE content of ALL devices in the pool=Dit WIST de inhoud van ALLE opslag in de groep
This will reboot the system=Dit zal het systeem herstarten
This will shutdown the system=Dit zal het systeem uitschakelen
This will stop the array=Dit zal de array stoppen
This will stop the running operation=Dit zal de lopende bewerking stoppen
Threshold=Drempel
Title=Titel
To confirm your action type %s=Om de actie te bevestigen type: %s
Toggle readswrites display=Schakel lezen/schrijven weergave
Too many attached devices Please consider upgrading your=Teveel aangesloten opslagmedia. Overweeg het upgraden van uw
Too many wrong andor missing disks=Teveel verkeerde en/of ontbrekende schijven
Total size=Totale grootte
Unassign ALL devices to delete this pool=Verwijder **ALLE** opslag om deze groep te verwijderen
Unassigned Devices=Niet-toegewezen apparaten 
unavailable no parity-check entries logged=Niet beschikbaar (geen pariteitscontrole info gelogd)
Unavailable - disk must be spun up=Niet beschikbaar - schijf moet worden aangezet
Unavailable=Niet beschikbaar
Unclean shutdown detected=Niet schone herstart gedetecteerd
Unmountable disk present=Ontkoppelde schijf aanwezig
Unmountable disks present=Ontkoppelde schijven aanwezig
Unmountable Encrypted volume present=Ontkoppeld: Versleuteld volume aanwezig
Unmountable Missing encryption key=Ontkoppeld: Ontbrekende versleuteling
Unmountable No file system=Ontkoppeld: geen bestandssysteem
Unmountable No pool uuid=Ontkoppeld: Geen groep uuid
Unmountable not btrfs pool=Ontkoppeld: geen btrfs groep
Unmountable Volume not encrypted=Ontkoppeld: volume niet versleuteld
Unmounted=Ontkoppeld
Upgrading diskswapping parity=Schijf upgraden/pariteit omwisselen
Use ASCII characters from space to tilde=Gebruik **ASCII** karakter van spatie " " tot tilde "~"
Use Default=Standaard
Use default=Standaard
Use only lowercase with no special characters or leadingtrailing digits=Gebruik alleen kleine letters zonder speciale tekens en start- of volgnummers
use printable characters only=gebruik alleen leesbare karakters
Used=Gebruikt
Value=Waarde
WARNING canceling may leave the array unprotected=WAARSCHUWING: annuleren kan de array onbeschermt laten
Warning disk temperature threshold=Schijftemperatuur alarmniveau
Warning disk utilization threshold=Schijfgebruik alarmniveau
WARNING=WAARSCHUWING
Warranty period=Garantieperiode
will activate a clean system power down=activeert een *schoon* uitschakelen van het systeem
will activate a clean system reset=activeert een *schoon* herstarten van het systeem
will bring the array on-line and start Clearing new data disks=maakt de array actief en start het **leegmaken** van nieuwe dataschijven
will bring the array on-line and start Parity-Check=maakt de array actief en start een **pariteitscontrole**
will bring the array on-line and start Parity-Sync andor Data-Rebuild=maakt de array actief en start een **pariteitssynchronisatie** en/of een **gegevensherbouw**
will bring the array on-line=maakt de array actief
will copy the parity information to the new parity disk=copieerd de pariteitsinformatie naar de nieuwe pariteitschijf
will create a file system in all Unmountable disks=maakt een bestandssysteem aan op alle ontkoppelde schijven
will delete the encryption keyfile=verwijdert het sleutelbestand
will disable the missing disk and then bring the array on-line Install a replacement disk as soon as possible=schakel alle ontbrekende schijven uit en maak de array actief
will expand the file system of the data disk if possible then bring the array on-line and start Data-Rebuild=vergroot het bestandssysteem indien mogelijk; maak daarna de array actief en start een gegevensherbouw actie
will immediately clear all disk statistics=schoont onmiddellijk alle schijfstatistieken op
will immediately invoke the Mover=start onmiddellijk de Mover
will immediately spin down all disks=zet alle schijven onmiddellijk uit
will immediately spin up all disks=zet alle schijven onmiddellijk aan
will pause the Clearing=pauzeert het lopende leegmaken
will pause the Parity-Check=pauzeert de lopende pariteitscontrole
will pause the Parity-SyncData-Rebuild=pauzeert de lopende pariteitssynchronisatie/gegevensherbouw
will pause the Read-Check=pauzeert de lopende leescontrole
will record all disk information and bring the array on-line=neemt alle schijfinformatie op en maakt de array actief
will record all disk information, bring the array on-line, and start Parity-Sync=neemt alle schijfinformatie op, maakt de array actief en start een pariteitssynchronisatie
will record the new disks information and bring the expanded array on-line=neemt alle schijfinformatie op en maakt de vergrootte array actief
will remove the missing cache disk and then bring the array on-line=verwijdert de ontbrekende groep schijf en maakt de array actief
will resume the paused Clearing=hervat het gepauzeerde leegmaken
will resume the paused Parity-Check=hervat de gepauzeerde pariteitscontrole
will resume the paused Parity-SyncData-Rebuild=hervat de gepauzeerde pariteitssynchronisatie/gegevensherbouw
will resume the paused Read-Check=hervat de gepauzeerde leescontrole
will start Clearing new data disks=start het **leegmaken** van nieuwe dataschijven
will start Parity-Check=start een **pariteitscontrole**
will start Parity-Sync andor Data-Rebuild=start een **pariteitssynchronisatie** en/of een **gegevensherbouw**
will start Read-Check of all array disks=start een **leescontrole** voor alle arrayschijven
will start Read-Check of all data disks=start een **leescontrole** voor alle dataschijven
will stop Clearing=stopt het lopende leegmaken
will stop Parity-SyncData-Rebuild=stopt de lopende pariteitssynchronisatie/gegevensherbouw
will stop the Parity-Check=stopt de lopende pariteitscontrole
will stop the Read-Check=stopt de lopende leescontrole
will take the array off-line=schakelt de array uit
Worst=Slechtst
Write corrections to parity=Schrijf correcties naar de pariteit
Writes=Schrijven
Wrong key=Verkeerde sleutel
xfs_repair status=xfs_repair status
You may not add new disks and also remove existing disks=U mag geen nieuwe schijven toevoegen en geen bestaande schijven verwijderen
your server=uw server
